lvy: oyl fyu wde kxs
ozc: ziu zyw omn kzo
mkn: emx
uqb: ksk qzd dev
ijk: ljo
twp: out
wgs: cyd oou aat
xry: yec isd qhl wsb
iog: mnx alc txi
ysm: xau qki jiy bsq qww ncs kdp bns
hwd: nhp nnw cpq yxi
cxm: igg twj
zpt: dac qpd ouf dmk vvw
qve: blh jts eis iyi mze cuw uks fwl
epv: pau ova
qld: dev
xir: iix qve
jkt: qve you iix
cab: iix
upc: qzc
pau: xbq
pkh: out
chr: nrs
tbt: umo uqw qld
gxe: hzw xfa qah
fzn: kzo omn
vtf: rgb qlh
kgt: uvw
ebl: rit nfd
umo: qzd ksk
xlf: nrw wbs
kzo: tbj xwp uum xva sob nzy uax mnk ahn dds fot wpd auy xlk dlf qkk yoo idv ruu udv
pjs: izd oyz ock
iyi: rzv
rob: umq
abs: eiz qmi coc
lza: hhq
cyo: kzo omn ziu
cyd: fzz pbd hop
fyu: dqy teq
mlz: scp
zne: dqf ixz izb cjz
htl: chr ffu fki
xpp: ljo
dqf: qzd dev
khb: fiq iaa
ogp: uqw qld
qpm: she qzx dju
zeh: csx cwj
bsq: ijj xoj zzo cqt
nto: qxt
cpq: ysm qmi eiz
lke: efe cwj
ueo: ovj ixw kwj
brf: ygg vvi
rov: ixz izb xck
kes: owe uqb
kpk: cqd snd
zvf: nok ltj lzo huh
uvw: ywx bxx nvg eii oia cpm dij ldu yyn axv tyr psu mdb
twv: mat bdo hib tve
nmk: qjz vrk cjb
zko: vnh
rzv: vnz xyo ntq
izb: ksk dev qzd
uqw: dev qzd
svr: zjh dxt ckp lsd dcu
dcu: uws cir ggg obv zvf iux kot dme kvn hvq ngw nmk qxn clm rjm pqn evt rub hzz dkk
nvg: emx rsl dyc izq
xau: dgb ijp
hzw: ygg cic
vlq: btf ixw ovj
kfj: hth qfw
tfs: ziu omn
xzd: tyg tnv xin
bnd: zys xiz
zvi: bdo hib mat
nok: mrg
fzz: hov
efe: xbq uvw mlu vkk
rpr: xzd wgf byr iro
kmm: whr jkt
obv: ltj lzo nok bjh huh
qia: bsq bpi qww nvk loo bns ncs qin tvs evj nkx
ruy: wyp
bqq: fvs zbf sad
xck: ksk
qhl: coc qmi eiz
bbc: cus vlq ueo
lzo: mrg
xin: hya hry
lgz: ffu chr
ugt: lke zeh
qah: vvi cic
dpo: phq
cwj: mlu vkk xbq uvw
coc: aut kdp nvk loo mcn tvs qin xxk bpi bif xkx skd snj qki
bgj: zyw kzo
ldu: dyc izq emx rsl
xdy: tob lyb rzv
jgb: bau hpt iul
ync: nox
iro: kyy tyg bkt tnv xin
owe: dev
edi: ysm coc
dqy: lod ijk cwu
bif: tbt yqy rjx
mlg: thk stk zko
tcp: yzl ruy mgy
cuw: zys uci xiz
bqr: nox mlz bbc cbb
cwu: ljo dqe vtb
yfk: vkk
mgy: tfs
eon: jss tgx fzn
eig: ogk khb
czp: kzo omn ziu
ncr: sad
iof: pxe umq rkc
bst: arl pau ova
lyb: xyo
qkk: bmo
yyn: bxj
fft: mat bdo tve
rzj: lft jgb bjo
pbd: hov vxt
kdp: cqt zzo xoj
ucg: kmm
vnz: dsf dse
udv: ped hnw
ijp: dem jbu zhb
ouf: omq jbo hca cab whh
hnw: nnw yxi
jnb: uhu
nnw: eiz qmi coc qia
oia: cof igg
dij: cof ztt igg
vkk: mdb tyr por tgm dij ldu yyn vrf oia eii cxm ywx bxx ucg
nvw: grn rjf
stc: qhr rvr
phs: ruy hey mgy
dqe: clj afb
nox: ueo cus
rsl: mlg vxp
rgd: fyu dgk wde
jmx: qfw nur hth
kwa: cwj
cjz: dev qzd
cqd: kep ozc
dse: ocp ltb qlh
mlu: oia eii nvg bxx ucg por tyr axv tgm yyn vrf ldu pot cpm juw mkn mdb psu
thk: nkc rxl hru
dnr: vhy
vvi: omn zyw ziu
ixw: oxn ddy
mrm: nkc vnh rxl xir
xfa: cic vvi
mze: lxo ekk
clm: ymp nid axl dpo
vhy: cyo tgx jss
nrw: ydy bgb
mmz: ogk rfb qhr
nbe: qia ysm eiz
nkc: you
mat: coc eiz
azl: ffu tpx jze
asp: mlu
tnv: hry hya xxd
kot: zje psk
vxp: stk thk zko
egt: iof
rub: lzo ltj nok huh
xnz: zeh kwa jqw
utp: nrw
lyz: cwu ijk xpp
mnk: fft
xst: pxe rkc
ctg: ksk
wkc: lft jgb tkh
lod: dqe
hke: qlh rgb ocp
dev: akp nou cqn ggw czi ebl cqy htl zfp xng mrc iog swh cqq lgz wgs gkq azl wbq wbr cfw pcb ffd
btf: oxn ddy kwu
jgs: mdh jdm
ctm: iix you
cus: ixw btf kwj
pcb: brx
nzy: zvi twv
vtb: clj
yxi: coc ysm qia
ohj: vwc srw bqq uhd
myw: qve you
ydy: qia eiz coc
ckq: iuj xry
wpd: yoj inr jsr axq
rjx: umo
ngw: huh ltj lzo bjh
aax: jmx odr
you: mfs rgd iyi iyu nom vmg blh oap lvy cdi aax fwl fgf xdy
umq: out
bdo: ysm eiz
qjx: jwd
tve: qmi coc qia ysm
pni: cyo fzn jss tgx
yce: ois hkw ujv nbe
ygg: omn kzo
xyo: vtf hke
jdm: kes ymm
byh: mmf
stk: xir hru
das: out
uoj: bqq vwc
lvx: uya ock oyz
huh: obt idl mrg
hkw: coc
qin: ogp yqy tbt
yzl: wyp tfs
aut: zne
ped: nhp nnw edi cpq
xxd: zos twp
ndu: mlu xbq uvw
mcn: mdy wvb zne
cqq: cyd
lxo: ryh
pny: kzo ziu zyw
ymm: uqb owe
dkk: dnr
zhf: qdw aos psk zje
fki: epv
obo: eon
hbd: zys uci
hya: zeo
aat: pbd fzz pzl hop
ujv: coc qia ysm
vrk: kpk ays lwl
vxt: mlu vkk
bxx: stc
ztt: ndx
rkh: xpp cwu
bsa: qoh jdm jnb
kfm: omn zyw
rfb: bgc yws
iyu: bqr ync
csx: mlu vkk uvw
alc: rsm xzx yoi
uhu: jlm
sad: vkk uvw
bxj: whr tdr nla
yoo: fek
kep: zyw ziu
tph: qah xfa hzw
akp: aat oou
nrs: ova
dac: jbo hca cab
byr: tnv
vvw: cab
mxu: out
ekk: iro byr ryh xzd
ymp: pjs phq lvx
hru: qve
ndx: you iix
exa: jdm
iul: out
mdy: izb dqf cjz xck
wvh: hkw
eis: jmx kfj
zje: tph jux gxe
ebr: uvw xbq vkk
auy: fek lza
xwp: inr nej yoj
jux: xfa qah brf hzw
odr: nur
axv: zpt xrt ydh
idl: czp kfm
fek: iuj hhq nki
psk: tph
ogk: fiq bgc yws ywd
qlc: kzo omn zyw ziu
sjs: whr tdr nla jkt
wbs: rdz
wgf: bkt kyy xin
afb: out
prd: lod ijk cwu
sob: xlf
kyy: hya xxd
zfp: nfd
mrc: zrh brx ifg
izd: pny
loo: wvb
azq: xst czy rob
cof: ctm ndx myw
mrg: zhc bgj kfm
dlf: fft twv zvi
ksk: wbr htl zfp ebl xng mrc cqq swh gkq ffd cfw akp azl nou cqn czi
qjz: kpk
arc: mlz
xoj: azn udq yvo
pqn: phs uer tcp
nwv: znh rzj grn
qua: umo qld
bmo: hhq nki xry
pzl: ndu hov
ocp: jur das
mzi: pau arl
qlh: das jur mxu
ffd: oou aat
vwc: ctz zbf asp sad
rgb: das
clj: out
yoj: wvh yce
sxy: snd ipf
dds: lza
srw: zbf ctz fvs asp
ptt: bqq vwc ncr srw
wen: ujv
hpt: out
rvr: bgc
bgb: coc qmi ysm qia
jnu: nto byh azn yvo
skd: ijp qsn
tcg: ziu kzo omn
whh: qve iix
qfw: azq egt qig
tgx: kzo ziu zyw
cir: lzo
ydh: ouf qpd dac vvw
hey: wyp kdu
jts: qhc
uci: nvw nwv
qtd: xiz
isd: qmi eiz ysm
sfc: lke jqw kwa
whr: qve you
clw: out
ujb: out
wyp: omn kzo
xzx: xbq uvw mlu vkk
bau: out
olb: cic ygg
nki: isd
arl: xbq vkk mlu
ahn: axq jsr
tyr: kmm
dyc: vxp cqw qjx mlg
kxs: rkh teq dqy
lft: hpt bau
bns: yqy
vnh: you qve iix
emx: qjx cqw vxp
omq: iix
wal: eig
idz: rob czy iof pul
oyz: qlc pny
uax: tpp ptg
ays: snd cqd
vrg: jxv
mdb: ywb ydh
nla: iix
zos: out
axl: lvx
cqt: azn
zyw: wpd auy qkk xlk idv yoo udv ruu xwp uum tbj nzy xva sob uax mnk dds fot ahn
kqo: kzo ziu
snd: ozc kqo
rit: ryz ptt mja ohj
ksw: cbb
cpm: bxj kmm sjs
ifg: jlw
mnx: ebr rsm yoi xzx
fot: fft twv zvi
dgb: dem jbu zhb
mva: odr jmx kfj njn
ggw: zrh
jiy: dgb qsn ijp
grn: bjo jgb
xdd: xbq
ckp: hzz evt uxi rub qxn pqn kvn ngw dme iux kot zvf obv uws zhf ggg cir
ova: vkk uvw
pot: ztt
rln: ruy mgy
wsb: ysm
iix: mze iyi iyu mfs rgd qtd mva fwl hbd bnd xdy nom vmg blh oap lvy
axq: wvh
uxi: qew obo
cqn: gwx
oou: hop pzl
ijj: yvo byh
qig: pul czy rob iof
zhc: zyw omn kzo
cjb: lwl kpk sxy
teq: ijk lod cwu
ywd: qve iix
pvb: olb
jlw: vkk mlu xbq
dem: qpm lyx
fvs: vkk xbq uvw
ovj: ddy oxn
qzy: ksk
tkh: bau ujb hpt
szr: lvx
ipf: kqo ozc
cjq: qoh mdh jnb jdm
ljo: pkh clj afb
yqy: umo uqw
dme: cjb
izq: cqw
xrt: ouf dac vvw dmk
igg: myw ctm psb
ruu: oro hnw ped
qdw: jux
bgc: you
dws: out
yws: iix
ziu: wpd auy qkk xlk dlf yoo udv ruu xwp uum tbj nzy sob mnk uax dds fot
znh: bjo lft jgb tkh
hry: zeo wrj clw
aos: pvb tph
zrh: xdd jlw yfk
czi: alc
hov: uvw
psu: dyc rsl emx
qew: pxa pni vhy
lwl: snd
phq: oyz izd
kvn: qew dnr
rjm: uer tcp rln phs
cic: ziu kzo omn
tvs: exa eui bsa
oxn: out
cww: kes ymm uhu
bkt: hya
dju: qzd
xxk: dgb qsn
zeo: out
tgm: xrt ydh zpt ywb
wbr: xnz ugt gry sfc
nvk: dgb qsn
ncs: zzo xoj ijj cqt jnu
yec: qia ysm qmi eiz coc
qzc: she dju
gry: jqw lke
txi: rsm xzx ebr
bfq: qfw hth nur
ptg: wbs iiz nrw
ddy: out
psb: you
xva: oro
por: izq dyc emx
cqy: zrh
pul: umq
fgf: njn jmx odr bfq
nhp: qmi eiz qia
dgk: teq prd
zjh: uws ggg cir zvf obv dme iux ngw qxn nmk pqn clm evt uxi rub hzz dkk
nom: ync
she: dev qzd ksk
kwu: out
eiz: snj evj jiy nkx xkx skd bif bpi bsq tvs xau nvk kdp ncs aut
mfs: ync arc
pxe: out
xbq: psu wal mdb mkn juw cpm pot ldu yyn vrf dij tgm axv por ucg nvg cxm eii oia
iux: aos psk qdw
mmf: ksk qzd
qhc: xyo
wde: lyz
ryz: vwc srw bqq
gwx: ptt ryz
kwj: kwu
tbj: ckq
nfd: mja uoj ptt
cdi: ekk lxo
obt: zhc kfm
bjo: ujb hpt
ixz: ksk dev
evj: jnu xoj
cqw: jwd mrm thk stk zko
fwl: tob lyb rzv
jxv: vkk
vmg: lxo ekk rpr
xng: sfc ugt
uya: tcg qlc
nid: lvx phq
rsm: vkk mlu uvw xbq
hca: qve
rdz: qmi
uks: arc ync bqr ksw
blh: tob rzv
xkx: qua rjx tbt yqy
eii: stc
qpd: whh cab jbo omq
tpp: wbs
swh: txi
iuj: yec
tyg: hya
iaa: you iix
jbo: qve you iix
dxt: uxi cir clm zhf rjm pqn hvq dkk ngw hzz
hvq: vrk
qzd: akp wbq ggw cqn czi htl wbr ebl cqy mrc xng iog lgz cqq swh gkq ffd wgs pcb
oyl: rkh
dmk: whh cab
pxi: wkc rjf grn
cfw: tpx
ltj: obt idl mrg
nur: egt idz azq
oap: oyl dgk
uhd: fvs zbf
vrf: mmz
ock: tcg qlc
ywx: twj cof ztt igg
ryh: bkt
ffu: bst nrs mzi vrg
njn: nur hth
ois: qmi qia
oro: nhp edi yxi
jss: omn zyw
nej: yce
tob: ntq vnz
qbv: mlu
jbu: lyx
jze: mzi epv bst
hib: eiz ysm qia
uws: dnr obo
yvo: qxt ctg
kdu: kzo zyw
evt: ymp szr axl dpo nid
qxn: rln phs
zbf: mlu vkk
qsn: upc jbu
azn: ctg mmf qxt
zzo: yvo nto byh
rxl: qve iix
czy: umq pxe
tpx: bst mzi
qoh: uhu
hzz: axl nid
jwd: hru xir nkc rxl
lyx: qzx qzy
jur: out
uum: hwd
zys: nvw pxi nwv
jlm: ksk
mdh: ymm
cbb: vlq
zhb: qpm
qxt: qzd dev ksk
fiq: iix qve
omn: ahn dds fot uax mnk xva sob nzy tbj uum xwp ruu udv yoo idv xlk dlf qkk wpd
snj: rjx
inr: yce wen wvh
eui: jnb qoh cww mdh
iiz: rdz ydy abs bgb
ywb: dac qpd
twj: myw psb
bpi: mdy wvb rov
wbq: xnz ugt
yoi: vkk xbq uvw
qhr: ywd iaa fiq
ggg: qjz
qww: eui jgs exa bsa
xiz: nwv
ltb: jur dws
ctz: xbq
rjf: jgb bjo
uer: yzl hey
wrj: out
jsr: wvh
rkc: out
brx: xdd kgt qbv
mja: srw
pxa: fzn cyo
idv: hwd ped
scp: btf ixw ovj
hth: egt qig azq
hop: hov
nou: aat
udq: mmf ctg
bjh: idl mrg
xlk: xlf utp tpp
ntq: hke dsf
qzx: qzd dev
lsd: evt uxi pqn clm dkk hzz zvf uws zhf cir ggg kvn hvq dme kot iux
qki: bsa cjq
nkx: bsa jgs exa eui
hhq: wsb
gkq: rit gwx
jqw: csx efe
dsf: qlh ltb rgb
tdr: you qve
qmi: aut loo nvk kdp ncs tvs qin xau mcn xxk bpi bsq qww bif bns skd snj evj jiy nkx
wvb: dqf izb xck
juw: stc eig
